111111111111111111111111111111111111111111111111111111111
100000000000000000000000111000000000000000000000000000011
100000000000000000000000111000000000000000000000000000011
100000000000000000000000111000000000000000000000000000011
100000000000000000000000111000000000000000000000000000011
01000000000~000000000000111000000000000000000000000000011
100000000000000000000000111000000000000000000000000000011
100000000000000000000000111000000000000000000000000000011
100000000000000000000000111000000000000000000000000000011
100000000000000000000000011000000000000000000000000000011
100000000000000000000000111000000000000000000000000000011
100000000000000000000000111000000000000000000000000000011
100000000000000000000000011000000000000000000000000000011
100000000111111111111111111000000000000011111100000000011
100000000111111111111111111000000000000011111110000000011
100000000111111111111111110000000000000011111111000000011
100000000111000000000000000000000000000011000000000000011
100000000111000000000000000000000000000011100000000000011
100000000111000000000000000000000000000011100000000000011
100000000111000000000000000000000000000011100000000000011
100000000111000000000000000000000000000011000000000000011
100000000111000000000000000000000000000111000000000000001
100000000111000000000000000000000000000011000000000000001
100000000111000000011100011000000000000111000000000000011
100000000111000000011100111000000000000011100000000000011
100000000111000000011100111000000000000011000000000000011
100000000111000000011100111000000000000011100000000000011
100000000111000000011100111000000000000011100000000000011
100000000111000000011100111000000001100111110011101000111
100000000111000000011111111000000001111111111111111111111
100000000110000000011111111000000011111111111111111111111
100000000000000000001011111000000011101011011001101000011
100000000000000000000000000000000011100000000000000000011
100000000000000000000000000000000011100000000000000000010
100000000000000000000000000000000011100000000000000000011
100000000000000000000000000000000011100000000020000000011
100000000000000000000000000000000001000000000000000000011
100000000000000000000000000000000000000000000000000000011
100000000000000000000000000000000000000000000000000000011
100000000000000000000000000000000000000000000000000000011
100000000000000000000000000000000000000000000000000000011
111111000000000000000000000000000000000000000000000000011
111111000000000000000000000000000000000000000000000000011
000011000000000000000000000000000000000000000000000000011
000011000000000000000000000000000000000000000000000001111
000011111111111111111111111111111111111111111111111111111
000011111111111111111111111111111111111111111111111111000